12:12
128 0 0 16 0  0  0 0 16 17 16 32
0	0 0  0 0  32 0 0 0  0   0 16
0	0 0 16 0  32 0 0 0  0   0 16
64	0 0 16 0  32 0 0 0  0   0 16
0	0 0 16 0  32 0 0 0  0   0 16
0	0 0 16 0  32 0 0 0  0   0 16
0	0 0 16 0  32 0 0 0  0   0 16
0	0 0 16 0  32 0 0 0  0   0 16
0	0 0 16 0  32 0 0 0  0   0 16
0	0 0 16 0  32 0 0 0  0   0 16
0	0 0 16 0  32 0 0 0  0   0 0
0	0 0 16 0  32 0 0 0  0   0 0